############################################################################################
############################################################################################
############################################################################################
##########        #############         #######         ####################################
#########             #######             #               ##################################
#########                                                  #################################
######### P                                                    #############################
#############                                                  #############################
##############                                              D  #############################
###############                                     ########################################
################              ##                    ########################################
#################     B     ######                  ########################################
######################################          ############################################
############################################################################################
############################################################################################
############################################################################################
############################################################################################
############################################################################################
############################################################################################
############################################################################################
############################################################################################
############################################################################################
############################################################################################
############################################################################################
############################################################################################
############################################################################################
############################################################################################
############################################################################################
############################################################################################
############################################################################################
############################################################################################
############################################################################################