############################################################################################
############################################################################################
#####    ###################################################################################
####                 ##########   ##########################################################
##         ########                #########################################################
##P        ###################       #######################################################
###       #####################     ########################################################
#####  #########################  B#########################################################
#####  #####################################################################################
#####  #################################        ############################################
######  #############################           ############################################
#######  ###########################          D ############################################
########  #########################     ####################################################
#########  ###################         #####################################################
##########  ################          ######################################################
###########  #####                #### #####################################################
############                 ##   ##########################################################
#############                     ##########################################################
############################################################################################
############################################################################################
############################################################################################
############################################################################################
############################################################################################
############################################################################################
############################################################################################
############################################################################################
############################################################################################
############################################################################################
############################################################################################
############################################################################################
############################################################################################
############################################################################################